Just So: An Odyssey into the Cosmic Web of Connection, Play, and True Pleasure
The Science of Enlightenment
The Singularity Is Nearer: When We Merge with AI
Proof of Life After Life: 7 Reasons to Believe There Is an Afterlife
Nexus: A Brief History of Information Networks from the Stone Age to AI
Determined: A Science of Life Without Free Will
The More Beautiful World Our Hearts Know Is Possible
Life as No One Knows It: The Physics of Life's Emergence
Memories, Dreams, Reflections
Beyond the Brain: The Survival of Human Consciousness After Permanent Bodily Death (BICS Presentation of Survival of Consciousness Essay Contest Three Top Winners)
The Worlds I See: Curiosity, Exploration, and Discovery at the Dawn of AI
AI Needs You: How We Can Change AI's Future and Save Our Own
Build the Life You Want: The Art and Science of Getting Happier
As a Man Thinketh: The Complete Original Edition and Master of Destiny: A GPS Guide to Life
The Expectation Effect: How Your Mindset Can Transform Your Life
AI Superpowers: China, Silicon Valley, and the New World Order
The Coming Wave: AI, Power, and Our Future
The Creative Act: A Way of Being
The Diabetes Code: Prevent and Reverse Type 2 Diabetes Naturally
Elon Musk
World Without Mind: The Existential Threat of Big Tech
How Emotions Are Made: The Secret Life of the Brain
The Experience Machine: How Our Minds Predict and Shape Reality
Waking Up: A Guide to Spirituality Without Religion
When China Rules the World: The End of the Western World and the Birth of a New Global Order
The Tibetan Book of the Dead: Liberation Through Understanding in the Between
The Seat of the Soul: 25th Anniversary Edition
God Is Not Dead: What Quantum Physics Tells Us About Our Origins and How We Should Live
You Are the Universe: Discovering Your Cosmic Self and Why It Matters
Quantum Jumps: An Extraordinary Science of Happiness and Prosperity
The Living Universe: Where Are We? Who Are We? Where Are We Going?
Conscious: A Brief Guide to the Fundamental Mystery of the Mind
The Universe in a Single Atom: The Convergence of Science and Spirituality
Meditations
Seveneves: A Novel
Synchrodestiny: Discover the Power of Meaningful Coincidence to Manifest Abundance in Your Life
A Life of Philip K. Dick: The Man Who Remembered the Future
The Selfish Gene
Living Grieving: Using Energy Medicine to Alchemize Grief and Loss
Beyond Death: The Best Evidence for the Survival of Human Consciousness
The Custodians: Beyond Abduction
Seeds of Awakening
Thinking, Fast and Slow
Story or Die: How to Use Brain Science to Engage, Persuade, and Change Minds in Business and in Life
Smile at Fear: Awakening the True Heart of Bravery
A Return to Love
Braiding Sweetgrass: Indigenous Wisdom, Scientific Knowledge and the Teachings of Plants
I Am Not the Body: Discovering the Truth Beyond Bondage
Real Magic: Ancient Wisdom, Modern Science, and a Guide to the Secret Power of the Universe
The Science of Being Great
The Art of Living: Peace and Freedom in the Here and Now
Letting Go: The Pathway of Surrender
Factfulness - Hvordan den moderne verden virkelig skal forstås
On the Path to Enlightenment: Heart Advice From the Great Tibetan Masters
Shape: The Hidden Geometry of Information, Biology, Strategy, Democracy, and Everything Else
The Attention Revolution: Unlocking the Power of the Focused Mind
The Things You Can See Only When You Slow Down: How to be Calm in a Busy World
Signs: The Secret Language of the Universe
Until the End of Time: Mind, Matter, and Our Search for Meaning in an Evolving Universe
Fundamentals: Ten Keys to Reality
Eat, Pray, Love: One Woman's Search for Everything Across Italy, India, and Indonesia
Liquid Rules: The Delightful and Dangerous Substances That Flow Through Our Lives
Same Soul, Many Bodies
The Tao Made Easy: Timeless Wisdom to Navigate a Changing World
Galileo's Error: Foundations for a New Science of Consciousness
Parenting the Confident Teen: Stop Disrespect and Raise a Confident Teenager
Time Reborn: From the Crisis in Physics to the Future of the Universe
The Doors of Perception
The Big Picture: On the Origins of Life, Meaning, and the Universe Itself
Dying to Wake Up: A Doctor's Voyage into the Afterlife and the Wisdom He Brought Back
Meister Eckhart's Living Wisdom: Indestructible Joy and the Path of Letting Go
Weapons of Math Destruction: How Big Data Increases Inequality and Threatens Democracy
After Buddhism: Rethinking the Dharma for a Secular Age
The Emperor's New Mind: Concerning Computers, Minds, and the Laws of Physics
What Is Real?: The Unfinished Quest for the Meaning of Quantum Physics
My Stroke of Insight
The Physics of Angels: Exploring the Realm Where Science and Spirit Meet
Zen: The Art of Simple Living
Ways to Go Beyond and Why They Work: Seven Spiritual Practices in a Scientific Age
The Age of Surveillance Capitalism: The Fight for a Human Future at the New Frontier of Power
The Case Against Reality: Why Evolution Hid the Truth from Our Eyes
Move Fast and Break Things: How Facebook, Google, and Amazon Cornered Culture and Undermined Democracy
More Together Than Alone
When I Say No, I Feel Guilty
A Guide to the Good Life: The Ancient Art of Stoic Joy
Nonzero: The Logic of Human Destiny
One Breath at a Time: Buddhism and the Twelve Steps
No-Nonsense Buddhism for Beginners: Clear Answers to Burning Questions About Core Buddhist Teachings
The Prophet
The Spontaneous Evolution Experience: The Choice to Become a New Species
Don't Believe Everything You Think: Living with Wisdom and Compassion
Buddhism for Beginners
The Monk Who Sold His Ferrari: A Spiritual Fable About Fulfilling Your Dreams & Reaching Your Destiny
Proof of Heaven: A Neurosurgeon's Journey into the Afterlife
High Magick: A Guide to the Spiritual Practices That Saved My Life on Death Row
Lost in Math: How Beauty Leads Physics Astray
The Snow Leopard
Science and the Akashic Field: An Integral Theory of Everything
WTF?: What's the Future and Why It's Up to Us
The Science of Mindfulness: A Research-Based Path to Well-Being
The Field - Updated Edition: The Quest for the Secret Force of the Universe
Why Buddhism Is True: The Science and Philosophy of Meditation and Enlightenment
The Fountainhead
The Greatest Story Ever Told - So Far: Why Are We Here?
Parallel Worlds: A Journey Through Creation, Higher Dimensions, and the Future of the Cosmos
The Pleasure of Finding Things Out: The Best Short Works of Richard P. Feynman
Throwing Rocks at the Google Bus: How Growth Became the Enemy of Prosperity
Is There Life After Death?: The Extraordinary Science of What Happens when We Die
Emma: An Audible Original Drama
Feeding the Dragon
The Untethered Soul: The Journey Beyond Yourself
The Surrender Experiment: My Journey into Life's Perfection
Stepping Out of Self-Deception: The Buddha's Liberating Teaching of No-Self
Life 3.0
Tao Te Ching: A New English Version
The Patterning Instinct: A Cultural History of Humanity’s Search for Meaning
The Tao of Physics
Radiant Mind: Teachings and Practices to Awaken Unconditioned Awareness
A Course in Miracles: Text, Vol. 1
Out of Your Mind
What the Buddha Taught
Freedom from the World
How to Have an Out of Body Experience: Transcend the Limits of Physical Form and Accelerate Your Spritual Evolution
The Elegant Universe: Superstrings, Hidden Dimensions, and the Quest for the Ultimate Theory
Head Strong: The Bulletproof Plan to Activate Untapped Brain Energy to Work Smarter and Think Faster - in Just Two Weeks
The Heart of the Buddha's Teaching: Transforming Suffering into Peace, Joy, and Liberation
Buddhism for Beginners [Jack Kornfield]
A Brief History of Time: From Big Bang to Black Holes
Practicing the Power of Now: Essential Teachings, Meditations, and Exercises From The Power of Now
A New Earth: Awakening Your Life's Purpose
The Divine Comedy
The Journey Into Yourself
The Power of Now: A Guide to Spiritual Enlightenment
The Drunkard's Walk: How Randomness Rules Our Lives
